1111111
11C0001
101E101
1010101
110P001
1001101
1111111