11111111
11C000111
101E101111
10101011111
110P001111
100110111
11111111