111111111
100000011
100CC0011
100000011
1000E0011
100C00011
100000011
100110011
110010111
111010011
1P0000011
111111111